###############################
#p     ** *  2 *   *  * * *   #
# # # #*# # #*#*# # # #*#*#*# #
#                             #
#*# # # # #*# # #*#*# # # # #*#
#            **  *  *   2     #
# # # # # # # #*#*#*# #*# # # #
#*  *      *  *   1  *        #
# # # # #*# # #*#*#*# # # # # #
#*    **  *       *           #
# #*# # # # # # # #*#*#*# # # #
#          *   *  *   1 *     #
###############################