###############################
#p     ** *  2 *   *  * * *   #
# # # #*# # #*#*# # # #*#*#*# #
#   *     ***         *   * * #
# # # # # #*# #*#*#*# # # # #*#
#      2     **  *  *         #
# # # # # # # # # # # #*# # # #
#*  *      *  *      *        #
# # # # #*# # # # #*# # # # # #
#*    **  *       *        1  #
# #*# # # # # # #*# # # # # # #
#           *   *  *          #
###############################